111111
1P0C00
101001
10C111
101101
111111 
