111111
1P0C01
101001
10C111
1011E1
111111
